1111111111111
100P000000001
1100C1111VC01
1E0011C00C0V1
1111111111111