11111111111111111111111
1C000000000000100C00001
10000000000000000000001
1101110000111100C000001
1E000000001111000000001
1111111000011100P000001
1C000000000001000000001
10000000000001000000001
11011100001111000000001
10000000000C0000000C001
11111111111111111111111